100|1|1|K|L|Daan
100|1|3|9|H|Daan
100|1|3|M|D|Daan
100|1|2|N|D|Daan
100|1|5|E|F|Daan
100|1|7|4|D|Daan
100|1|2|V|L|Daan
100|1|3|a|D|Daan
100|1|7|C|L|Daan
